Step #,"Ψ (xx,roll)","θ (yy, pitch)","ϕ (zz,yaw)",X,Y,ΔZ,Time (ms)
0,0,0,0,0,0,0,1
1,5,0,0,0,0,1,1000
2,-2,5,0,0,0,1,1500
3,5,0,0,0,0,1,2000
4,3,-3,0,0,0,1,2000
5,1,1,0,0,0,1,500
6,0,0,0,0,0,0,1000
